32
0 0 0 0 0 0 0 0 32 0
0 0 0 0 0 0 0 0 31 0
0 0 0 0 0 0 0 0 30 0
0 0 0 0 0 0 0 0 29 0
0 21 22 23 24 25 26 27 28 0
0 20 0 0 0 0 0 0 0 0
0 19 0 0 0 0 0 0 0 0
0 18 0 0 0 0 0 0 0 0
0 17 0 0 0 0 0 0 0 0
0 16 15 14 13 12 11 10 9 0
0 0 0 0 0 0 0 0 8 0
0 0 0 0 0 0 0 0 7 0
0 0 0 0 0 0 0 0 6 0
0 0 0 0 0 0 0 0 5 0
0 0 0 0 0 0 0 0 4 0
0 0 0 0 0 0 0 0 3 0
0 0 0 0 0 0 0 0 2 0
0 0 0 0 0 0 0 0 1 0