32
0 0 0 0 0 0 0 0 1 0
0 0 0 0 0 0 0 0 2 0
0 0 0 0 0 0 0 0 3 0
0 0 0 0 0 0 0 0 4 0
0 12 11 10 9 8 7 6 5 0
0 13 0 0 0 0 0 0 0 0
0 14 0 0 0 0 0 0 0 0
0 15 0 0 0 0 0 0 0 0
0 16 0 0 0 0 0 0 0 0
0 17 18 19 20 21 22 23 24 0
0 0 0 0 0 0 0 0 25 0
0 0 0 0 0 0 0 0 26 0
0 0 0 0 0 0 0 0 27 0
0 0 0 0 0 0 0 0 28 0
0 0 0 0 0 0 0 0 29 0
0 0 0 0 0 0 0 0 30 0
0 0 0 0 0 0 0 0 31 0
0 0 0 0 0 0 0 0 32 0